number,name,kor,eng,math,total,avg,rank,create_date
1,Siouxie,87,76,84,247,82,0,2024-04-18
2,Athene,77,69,65,211,70,0,2024-04-12
3,Corella,93,71,73,237,79,0,2024-04-15
4,Bryn,96,53,62,211,70,0,2024-04-11
5,Hieronymus,71,81,97,249,83,0,2024-04-15
6,Edita,86,96,60,242,80,0,2024-04-10
7,Shelagh,76,78,59,213,71,0,2024-04-19
8,Deloria,99,64,71,234,78,0,2024-04-16
9,Devinne,72,50,84,206,68,0,2024-04-10
10,Baillie,51,77,65,193,64,0,2024-04-22
11,Joannes,88,60,94,242,80,0,2024-04-11
12,Pippa,57,82,100,239,79,0,2024-04-18
13,Marcy,60,65,88,213,71,0,2024-04-12
14,Cori,87,81,59,227,75,0,2024-04-17
15,Nestor,79,71,79,229,76,0,2024-04-15
16,Minta,74,86,71,231,77,0,2024-04-22
17,Geri,76,96,76,248,82,0,2024-04-17
18,Kellina,60,60,70,190,63,0,2024-04-19
19,Clementine,62,60,51,173,57,0,2024-04-14
20,Rabi,92,52,85,229,76,0,2024-04-16
21,Minda,55,72,71,198,66,0,2024-04-15
22,Donni,54,82,82,218,72,0,2024-04-23
23,Rozelle,54,66,53,173,57,0,2024-04-13
24,Cissiee,99,70,92,261,87,0,2024-04-23
25,Audrye,74,82,57,213,71,0,2024-04-16
26,Gwenneth,87,90,97,274,91,0,2024-04-17
27,Carline,80,65,71,216,72,0,2024-04-19
28,Sunshine,55,81,80,216,72,0,2024-04-20
29,Arielle,97,64,59,220,73,0,2024-04-18
30,Kym,84,84,69,237,79,0,2024-04-18
31,Cesaro,61,72,66,199,66,0,2024-04-19
32,Hadlee,62,81,59,202,67,0,2024-04-11
33,Erda,68,77,90,235,78,0,2024-04-22
34,Jennica,85,81,80,246,82,0,2024-04-16
35,Joela,93,70,93,256,85,0,2024-04-12
36,Marlane,55,55,56,166,55,0,2024-04-13
37,Bettina,58,82,75,215,71,0,2024-04-19
38,Amalea,50,83,84,217,72,0,2024-04-19
39,Mercy,82,55,76,213,71,0,2024-04-22
40,Brandtr,58,86,55,199,66,0,2024-04-20
41,Fredek,82,88,89,259,86,0,2024-04-18
42,Matteo,77,52,98,227,75,0,2024-04-21
43,Fancy,57,82,85,224,74,0,2024-04-19
44,Kelbee,66,66,88,220,73,0,2024-04-19
45,Deck,65,56,82,203,67,0,2024-04-11
46,Addia,95,57,60,212,70,0,2024-04-16
47,Tan,67,94,68,229,76,0,2024-04-16
48,Veda,88,97,75,260,86,0,2024-04-22
49,Aguste,75,93,97,265,88,0,2024-04-10
50,Smith,86,100,67,253,84,0,2024-04-18
51,Pebrook,67,98,91,256,85,0,2024-04-12
52,Laurie,99,89,61,249,83,0,2024-04-18
53,Shir,62,86,93,241,80,0,2024-04-13
54,Amata,95,75,86,256,85,0,2024-04-19
55,Amalee,97,82,78,257,85,0,2024-04-17
56,Jeannette,75,86,69,230,76,0,2024-04-11
57,Jordain,89,60,66,215,71,0,2024-04-22
58,Olag,70,73,85,228,76,0,2024-04-11
59,Bridie,91,100,80,271,90,0,2024-04-19
60,Cos,99,90,98,287,95,0,2024-04-11
61,Ara,86,91,74,251,83,0,2024-04-22
62,Alayne,83,76,56,215,71,0,2024-04-20
63,Stanislaw,70,90,68,228,76,0,2024-04-14
64,Gerrilee,68,72,56,196,65,0,2024-04-23
65,Davin,78,84,64,226,75,0,2024-04-15
66,Tony,52,67,65,184,61,0,2024-04-18
67,Twyla,94,93,62,249,83,0,2024-04-18
68,Ellwood,68,74,94,236,78,0,2024-04-14
69,Nilson,58,51,99,208,69,0,2024-04-15
70,Edvard,96,70,51,217,72,0,2024-04-15
71,Karena,54,51,93,198,66,0,2024-04-14
72,Barnabas,55,84,72,211,70,0,2024-04-16
73,Daveen,86,54,73,213,71,0,2024-04-21
74,Belicia,85,94,70,249,83,0,2024-04-21
75,Peggie,98,79,90,267,89,0,2024-04-14
76,Guillaume,100,74,87,261,87,0,2024-04-12
77,Pen,51,62,80,193,64,0,2024-04-15
78,Dominic,68,90,98,256,85,0,2024-04-14
79,Luci,73,87,83,243,81,0,2024-04-16
80,Dewie,94,95,78,267,89,0,2024-04-20
81,Andy,100,80,56,236,78,0,2024-04-17
82,Helga,58,53,54,165,55,0,2024-04-16
83,Gallagher,91,89,74,254,84,0,2024-04-16
84,Dee dee,89,96,65,250,83,0,2024-04-19
85,Gerald,55,64,55,174,58,0,2024-04-17
86,Floyd,78,60,87,225,75,0,2024-04-12
87,Neile,99,62,70,231,77,0,2024-04-13
88,Kiersten,84,53,79,216,72,0,2024-04-22
89,Karon,64,53,63,180,60,0,2024-04-14
90,Tabina,77,79,63,219,73,0,2024-04-14
91,Obed,75,93,56,224,74,0,2024-04-10
92,Floyd,61,61,90,212,70,0,2024-04-12
93,Hayley,88,96,92,276,92,0,2024-04-23
94,Claire,74,92,76,242,80,0,2024-04-13
95,Jere,96,56,67,219,73,0,2024-04-23
96,Piper,86,78,84,248,82,0,2024-04-23
97,Monty,91,69,86,246,82,0,2024-04-20
98,Merlina,58,59,78,195,65,0,2024-04-12
99,Jephthah,70,51,82,203,67,0,2024-04-16
100,Leoline,52,59,57,168,56,0,2024-04-17
101,Aggi,72,58,88,218,72,0,2024-04-18
102,Jeramie,95,63,69,227,75,0,2024-04-15
103,Dannie,60,92,53,205,68,0,2024-04-20
104,Adrienne,89,81,69,239,79,0,2024-04-10
105,Suki,50,64,97,211,70,0,2024-04-18
106,Dotti,66,65,93,224,74,0,2024-04-22
107,Thain,64,64,77,205,68,0,2024-04-20
108,Magdalene,100,84,86,270,90,0,2024-04-21
109,Gualterio,64,74,97,235,78,0,2024-04-21
110,Stillmann,83,76,60,219,73,0,2024-04-22
111,Julina,70,72,84,226,75,0,2024-04-11
112,Eddie,84,72,66,222,74,0,2024-04-13
113,Iver,86,80,89,255,85,0,2024-04-11
114,Willem,84,93,75,252,84,0,2024-04-16
115,Winifield,92,98,82,272,90,0,2024-04-19
116,Selma,98,63,73,234,78,0,2024-04-16
117,Marcelia,54,58,62,174,58,0,2024-04-17
118,Winfred,81,79,91,251,83,0,2024-04-17
119,Darsey,54,78,72,204,68,0,2024-04-15
120,Hugo,99,76,100,275,91,0,2024-04-12
121,Winthrop,90,96,94,280,93,0,2024-04-12
122,Frankie,55,65,85,205,68,0,2024-04-10
123,Christie,63,73,73,209,69,0,2024-04-15
124,Traci,65,99,55,219,73,0,2024-04-10
125,Renard,66,91,64,221,73,0,2024-04-23
126,Winny,86,81,93,260,86,0,2024-04-11
127,Merna,71,61,82,214,71,0,2024-04-15
128,Chane,75,63,100,238,79,0,2024-04-19
129,Gregoor,70,57,50,177,59,0,2024-04-19
130,Randolph,97,85,53,235,78,0,2024-04-16
131,Fionnula,66,67,68,201,67,0,2024-04-22
132,Ruby,77,67,74,218,72,0,2024-04-12
133,Manda,80,85,89,254,84,0,2024-04-19
134,Lee,54,87,79,220,73,0,2024-04-11
135,Nissie,57,75,61,193,64,0,2024-04-13
136,Elana,88,70,69,227,75,0,2024-04-18
137,Paco,64,96,64,224,74,0,2024-04-21
138,Sheelagh,85,66,57,208,69,0,2024-04-19
139,Milli,76,66,75,217,72,0,2024-04-11
140,Lianne,81,51,59,191,63,0,2024-04-12
141,Zed,66,77,92,235,78,0,2024-04-19
142,Kipp,93,59,94,246,82,0,2024-04-21
143,Con,57,90,93,240,80,0,2024-04-23
144,Glynis,72,60,64,196,65,0,2024-04-20
145,Cati,92,94,81,267,89,0,2024-04-19
146,Josefa,62,86,51,199,66,0,2024-04-17
147,Tonnie,92,86,52,230,76,0,2024-04-11
148,Adda,86,95,68,249,83,0,2024-04-23
149,Eba,96,80,60,236,78,0,2024-04-21
150,Leonard,92,98,89,279,93,0,2024-04-10
151,Rafaelia,64,77,55,196,65,0,2024-04-23
152,Kristal,66,66,81,213,71,0,2024-04-18
153,Angelia,77,81,58,216,72,0,2024-04-22
154,Carleen,62,94,50,206,68,0,2024-04-19
155,Erminie,92,52,96,240,80,0,2024-04-12
156,Reeta,93,52,100,245,81,0,2024-04-20
157,Orson,71,85,65,221,73,0,2024-04-16
158,Issie,65,51,78,194,64,0,2024-04-14
159,Milly,67,56,69,192,64,0,2024-04-13
160,Vanya,82,96,74,252,84,0,2024-04-17
161,Gerry,95,100,84,279,93,0,2024-04-14
162,Drugi,76,59,96,231,77,0,2024-04-20
163,Adan,67,50,54,171,57,0,2024-04-22
164,Wang,63,52,100,215,71,0,2024-04-10
165,Felice,78,59,57,194,64,0,2024-04-16
166,Athene,92,100,66,258,86,0,2024-04-22
167,Ivar,72,85,90,247,82,0,2024-04-10
168,Zebulen,56,52,94,202,67,0,2024-04-23
169,Selene,90,75,96,261,87,0,2024-04-20
170,Bale,83,98,53,234,78,0,2024-04-19
171,Morganica,74,93,98,265,88,0,2024-04-19
172,Nissie,77,50,50,177,59,0,2024-04-23
173,Leonidas,90,89,62,241,80,0,2024-04-23
174,Tabbie,55,91,89,235,78,0,2024-04-20
175,Mignonne,58,74,55,187,62,0,2024-04-23
176,Gwenora,51,61,86,198,66,0,2024-04-17
177,Felizio,51,69,66,186,62,0,2024-04-21
178,Adriaens,67,63,99,229,76,0,2024-04-16
179,Elinore,75,82,80,237,79,0,2024-04-22
180,Loralee,75,94,55,224,74,0,2024-04-21
181,Bard,66,57,55,178,59,0,2024-04-12
182,Adelheid,97,72,76,245,81,0,2024-04-13
183,Marianna,50,58,59,167,55,0,2024-04-23
184,Moreen,73,89,76,238,79,0,2024-04-13
185,Zenia,59,78,66,203,67,0,2024-04-20
186,Denyse,75,99,57,231,77,0,2024-04-13
187,Barn,61,60,78,199,66,0,2024-04-19
188,Gladys,100,91,52,243,81,0,2024-04-18
189,Filippo,71,96,82,249,83,0,2024-04-17
190,Floria,91,77,75,243,81,0,2024-04-23
191,Maury,96,100,99,295,98,0,2024-04-12
192,Lucie,56,91,78,225,75,0,2024-04-21
193,Dyane,70,50,75,195,65,0,2024-04-19
194,Chadd,73,61,88,222,74,0,2024-04-12
195,Perry,90,72,83,245,81,0,2024-04-10
196,Elsa,97,76,70,243,81,0,2024-04-18
197,Niels,98,63,95,256,85,0,2024-04-21
198,Edith,98,60,80,238,79,0,2024-04-17
199,Bethena,93,58,89,240,80,0,2024-04-23
200,Ursala,70,93,84,247,82,0,2024-04-10
201,Celinka,54,52,91,197,65,0,2024-04-15
202,Kacey,69,92,77,238,79,0,2024-04-19
203,Angelle,51,96,62,209,69,0,2024-04-13
204,Lurline,77,66,63,206,68,0,2024-04-14
205,Corabella,50,59,90,199,66,0,2024-04-15
206,Seana,57,81,50,188,62,0,2024-04-13
207,Abdel,95,93,75,263,87,0,2024-04-19
208,Elizabeth,63,75,68,206,68,0,2024-04-10
209,Ansley,83,92,88,263,87,0,2024-04-23
210,Rickie,74,54,61,189,63,0,2024-04-18
211,Yorgos,61,67,74,202,67,0,2024-04-13
212,Rosina,63,75,92,230,76,0,2024-04-22
213,Therine,86,79,61,226,75,0,2024-04-10
214,Todd,84,73,91,248,82,0,2024-04-17
215,Diarmid,51,58,79,188,62,0,2024-04-17
216,Roderigo,56,86,84,226,75,0,2024-04-15
217,Delaney,51,50,60,161,53,0,2024-04-12
218,Lawton,58,68,85,211,70,0,2024-04-21
219,Jeno,53,93,74,220,73,0,2024-04-15
220,Jemie,72,53,73,198,66,0,2024-04-10
221,Andras,55,74,87,216,72,0,2024-04-16
222,Joseito,75,72,75,222,74,0,2024-04-15
223,Carney,56,100,66,222,74,0,2024-04-17
224,Augie,79,85,87,251,83,0,2024-04-14
225,Ulrick,96,70,64,230,76,0,2024-04-17
226,Jodie,96,57,55,208,69,0,2024-04-12
227,Fin,54,90,51,195,65,0,2024-04-13
228,Jerrine,94,58,100,252,84,0,2024-04-19
229,Morgana,94,84,99,277,92,0,2024-04-22
230,Tamiko,57,60,63,180,60,0,2024-04-11
231,Florie,99,66,68,233,77,0,2024-04-13
232,Amanda,65,61,69,195,65,0,2024-04-18
233,Sheri,68,100,76,244,81,0,2024-04-10
234,Falito,64,89,96,249,83,0,2024-04-23
235,Cord,52,95,71,218,72,0,2024-04-17
236,Darla,67,71,91,229,76,0,2024-04-20
237,Eleanor,91,68,68,227,75,0,2024-04-15
238,Vergil,74,85,63,222,74,0,2024-04-16
239,Olia,67,53,88,208,69,0,2024-04-10
240,Padgett,55,58,73,186,62,0,2024-04-10
241,Katrine,81,51,85,217,72,0,2024-04-19
242,Rriocard,73,85,70,228,76,0,2024-04-14
243,Hayden,87,61,87,235,78,0,2024-04-13
244,Georgeta,95,68,50,213,71,0,2024-04-17
245,Rosemary,71,98,91,260,86,0,2024-04-12
246,Selig,73,99,78,250,83,0,2024-04-14
247,Elissa,90,88,85,263,87,0,2024-04-23
248,Onfroi,62,92,55,209,69,0,2024-04-11
249,Eberto,84,71,75,230,76,0,2024-04-15
250,Roxie,84,60,81,225,75,0,2024-04-18
251,Iolanthe,65,56,75,196,65,0,2024-04-23
252,Tracie,78,80,82,240,80,0,2024-04-10
253,Waring,54,68,69,191,63,0,2024-04-20
254,Burgess,53,70,93,216,72,0,2024-04-18
255,Idette,96,61,70,227,75,0,2024-04-13
256,Tiphany,54,88,85,227,75,0,2024-04-10
257,Sissie,64,55,80,199,66,0,2024-04-19
258,Wendye,50,64,92,206,68,0,2024-04-23
259,Nikita,68,97,50,215,71,0,2024-04-20
260,Conan,100,56,89,245,81,0,2024-04-10
261,Malina,100,51,78,229,76,0,2024-04-19
262,Ranee,54,94,86,234,78,0,2024-04-10
263,Faye,91,77,84,252,84,0,2024-04-10
264,Tadeo,93,97,78,268,89,0,2024-04-20
265,Karlie,60,95,84,239,79,0,2024-04-12
266,Vally,84,55,65,204,68,0,2024-04-11
267,Brunhilde,85,91,89,265,88,0,2024-04-20
268,Moishe,57,61,60,178,59,0,2024-04-18
269,Homer,100,63,78,241,80,0,2024-04-20
270,Shermie,58,56,89,203,67,0,2024-04-15
271,Philippa,76,86,73,235,78,0,2024-04-10
272,Hasheem,82,84,53,219,73,0,2024-04-17
273,Reinald,67,65,68,200,66,0,2024-04-10
274,Gerard,70,55,76,201,67,0,2024-04-19
275,Katie,100,92,61,253,84,0,2024-04-21
276,Stafford,75,96,57,228,76,0,2024-04-18
277,Gayler,58,80,96,234,78,0,2024-04-11
278,Dorine,92,90,54,236,78,0,2024-04-16
279,Melita,66,86,65,217,72,0,2024-04-23
280,Delmer,74,76,84,234,78,0,2024-04-21
281,Willdon,68,94,72,234,78,0,2024-04-13
282,Perry,80,72,88,240,80,0,2024-04-21
283,Margie,67,91,51,209,69,0,2024-04-15
284,Steffen,75,66,91,232,77,0,2024-04-13
285,Rollins,52,95,59,206,68,0,2024-04-20
286,Sarina,62,68,97,227,75,0,2024-04-20
287,Germaine,51,94,78,223,74,0,2024-04-18
288,Deloria,59,92,61,212,70,0,2024-04-10
289,Tiffy,76,56,70,202,67,0,2024-04-18
290,Matty,91,75,94,260,86,0,2024-04-14
291,Carly,100,82,54,236,78,0,2024-04-14
292,Yard,73,83,72,228,76,0,2024-04-14
293,Charmane,64,61,84,209,69,0,2024-04-23
294,Crosby,51,78,66,195,65,0,2024-04-12
295,Sophi,73,81,71,225,75,0,2024-04-13
296,Payton,69,79,64,212,70,0,2024-04-10
297,Halimeda,80,100,83,263,87,0,2024-04-20
298,Karlotta,96,64,51,211,70,0,2024-04-11
299,Viola,91,74,50,215,71,0,2024-04-14
300,Goddart,65,59,87,211,70,0,2024-04-21
301,Toddie,96,81,81,258,86,0,2024-04-18
302,Patrizia,88,100,64,252,84,0,2024-04-11
303,Roger,69,59,78,206,68,0,2024-04-12
304,Frederich,96,52,54,202,67,0,2024-04-16
305,Dominik,64,97,69,230,76,0,2024-04-23
306,Barnabas,66,79,89,234,78,0,2024-04-19
307,Gwendolyn,63,71,93,227,75,0,2024-04-18
308,Christoforo,59,56,63,178,59,0,2024-04-11
309,Letti,54,51,70,175,58,0,2024-04-10
310,Inge,72,80,77,229,76,0,2024-04-11
311,Marcellina,93,58,72,223,74,0,2024-04-18
312,Melany,92,93,98,283,94,0,2024-04-22
313,Lyell,97,89,94,280,93,0,2024-04-19
314,Vanessa,61,77,90,228,76,0,2024-04-16
315,Ariel,72,88,61,221,73,0,2024-04-15
316,Dunn,78,78,68,224,74,0,2024-04-21
317,Sam,87,57,50,194,64,0,2024-04-13
318,Leelah,56,73,85,214,71,0,2024-04-22
319,Doralynn,92,94,62,248,82,0,2024-04-11
320,Berny,84,52,92,228,76,0,2024-04-22
321,Denni,85,54,67,206,68,0,2024-04-22
322,Barris,91,87,79,257,85,0,2024-04-19
323,Donni,57,96,61,214,71,0,2024-04-17
324,Desdemona,86,69,54,209,69,0,2024-04-20
325,Korney,95,100,84,279,93,0,2024-04-16
326,Opalina,73,70,88,231,77,0,2024-04-21
327,Donella,53,78,76,207,69,0,2024-04-11
328,Alexi,86,80,60,226,75,0,2024-04-21
329,Bernadene,56,95,85,236,78,0,2024-04-21
330,Erena,98,54,63,215,71,0,2024-04-11
331,Aldric,97,95,57,249,83,0,2024-04-17
332,Koressa,61,78,54,193,64,0,2024-04-19
333,Arni,67,68,51,186,62,0,2024-04-10
334,Loria,73,67,94,234,78,0,2024-04-16
335,Sara,98,61,85,244,81,0,2024-04-18
336,Simon,98,69,53,220,73,0,2024-04-15
337,Hobard,51,94,52,197,65,0,2024-04-22
338,Artie,61,58,67,186,62,0,2024-04-23
339,Mela,70,86,93,249,83,0,2024-04-18
340,Davine,53,89,50,192,64,0,2024-04-19
341,Daryle,80,73,55,208,69,0,2024-04-17
342,Hagan,89,56,81,226,75,0,2024-04-12
343,Cordi,75,89,100,264,88,0,2024-04-13
344,Kacie,61,67,81,209,69,0,2024-04-12
345,Kelsey,62,83,93,238,79,0,2024-04-22
346,Farlee,67,98,96,261,87,0,2024-04-15
347,Nari,62,53,78,193,64,0,2024-04-20
348,Janina,75,92,74,241,80,0,2024-04-21
349,Lezley,54,59,55,168,56,0,2024-04-15
350,Fabe,77,99,61,237,79,0,2024-04-17
351,Dick,57,73,88,218,72,0,2024-04-19
352,Tiffany,67,84,53,204,68,0,2024-04-19
353,Noell,59,71,85,215,71,0,2024-04-11
354,Stoddard,66,50,71,187,62,0,2024-04-11
355,Auria,78,98,96,272,90,0,2024-04-14
356,Franni,51,96,91,238,79,0,2024-04-11
357,Helsa,50,60,64,174,58,0,2024-04-16
358,Stefania,96,59,67,222,74,0,2024-04-19
359,Jozef,84,87,77,248,82,0,2024-04-20
360,Anne-corinne,77,53,62,192,64,0,2024-04-23
361,Ennis,62,67,55,184,61,0,2024-04-15
362,Pietro,100,79,53,232,77,0,2024-04-11
363,Brittney,95,94,50,239,79,0,2024-04-15
364,Jammal,59,74,70,203,67,0,2024-04-23
365,Winslow,79,68,54,201,67,0,2024-04-14
366,Isabeau,69,80,93,242,80,0,2024-04-19
367,Barbra,63,66,68,197,65,0,2024-04-15
368,Tabby,58,89,74,221,73,0,2024-04-18
369,Lorna,71,83,50,204,68,0,2024-04-13
370,Gael,68,50,93,211,70,0,2024-04-20
371,Poppy,50,58,56,164,54,0,2024-04-11
372,Jareb,65,55,96,216,72,0,2024-04-13
373,Felice,59,55,65,179,59,0,2024-04-21
374,Brock,53,71,97,221,73,0,2024-04-14
375,Marianna,72,79,86,237,79,0,2024-04-10
376,Kippie,69,73,71,213,71,0,2024-04-11
377,Mead,83,68,63,214,71,0,2024-04-10
378,Hal,54,55,95,204,68,0,2024-04-18
379,Rosemarie,73,94,54,221,73,0,2024-04-17
380,Shermy,84,59,64,207,69,0,2024-04-22
381,Dalia,97,55,64,216,72,0,2024-04-17
382,Nicolas,75,97,75,247,82,0,2024-04-21
383,Richie,52,61,70,183,61,0,2024-04-10
384,Hayes,52,83,85,220,73,0,2024-04-18
385,Tallie,63,97,89,249,83,0,2024-04-14
386,Aviva,77,60,83,220,73,0,2024-04-15
387,Fraser,99,71,83,253,84,0,2024-04-22
388,Giacomo,85,83,57,225,75,0,2024-04-23
389,Ardelia,69,93,94,256,85,0,2024-04-21
390,Kyle,98,85,99,282,94,0,2024-04-18
391,Borg,96,85,72,253,84,0,2024-04-16
392,Bondon,66,74,75,215,71,0,2024-04-21
393,Torr,91,72,77,240,80,0,2024-04-17
394,El,92,65,69,226,75,0,2024-04-21
395,Leoline,95,96,65,256,85,0,2024-04-16
396,Nicole,92,66,75,233,77,0,2024-04-23
397,Eustacia,85,95,100,280,93,0,2024-04-22
398,Angelika,53,83,57,193,64,0,2024-04-18
399,Libbey,72,57,90,219,73,0,2024-04-10
400,Tod,100,71,100,271,90,0,2024-04-15
401,Carmelita,75,96,66,237,79,0,2024-04-20
402,Josias,67,73,51,191,63,0,2024-04-10
403,Millisent,58,84,69,211,70,0,2024-04-18
404,Dewie,72,90,56,218,72,0,2024-04-10
405,Winston,100,84,53,237,79,0,2024-04-22
406,Phyllis,79,91,55,225,75,0,2024-04-14
407,Kit,81,74,94,249,83,0,2024-04-11
408,Ricardo,99,99,93,291,97,0,2024-04-23
409,Starr,90,73,86,249,83,0,2024-04-20
410,Jonah,78,95,92,265,88,0,2024-04-19
411,Gerry,87,53,82,222,74,0,2024-04-19
412,Doretta,84,97,64,245,81,0,2024-04-22
413,Nertie,92,76,53,221,73,0,2024-04-16
414,Lise,69,58,95,222,74,0,2024-04-17
415,Fulton,62,66,50,178,59,0,2024-04-13
416,Sisile,84,99,100,283,94,0,2024-04-16
417,Bale,96,50,79,225,75,0,2024-04-23
418,Concettina,75,99,89,263,87,0,2024-04-22
419,Caritta,52,56,62,170,56,0,2024-04-15
420,Lind,62,71,88,221,73,0,2024-04-22
421,Winslow,89,68,68,225,75,0,2024-04-17
422,George,58,55,75,188,62,0,2024-04-21
423,Viole,96,86,54,236,78,0,2024-04-13
424,Kareem,92,60,91,243,81,0,2024-04-11
425,Alida,55,90,67,212,70,0,2024-04-23
426,Darryl,86,87,63,236,78,0,2024-04-21
427,Isidoro,79,51,65,195,65,0,2024-04-14
428,Rees,69,50,96,215,71,0,2024-04-21
429,Lyon,80,72,51,203,67,0,2024-04-10
430,Karney,69,62,91,222,74,0,2024-04-20
431,Odessa,88,66,55,209,69,0,2024-04-19
432,Quentin,98,92,89,279,93,0,2024-04-17
433,Sisely,63,58,88,209,69,0,2024-04-12
434,Trescha,70,91,64,225,75,0,2024-04-11
435,Heather,50,79,69,198,66,0,2024-04-22
436,Cecil,65,64,91,220,73,0,2024-04-12
437,Ariella,72,53,62,187,62,0,2024-04-13
438,Orelie,73,75,76,224,74,0,2024-04-22
439,Christie,62,91,57,210,70,0,2024-04-19
440,Susie,85,55,69,209,69,0,2024-04-10
441,Shea,97,90,92,279,93,0,2024-04-18
442,Cilka,91,66,61,218,72,0,2024-04-15
443,Holden,50,76,100,226,75,0,2024-04-22
444,Bevan,56,50,76,182,60,0,2024-04-22
445,Beret,59,95,69,223,74,0,2024-04-17
446,Gallard,98,97,66,261,87,0,2024-04-14
447,Sybilla,78,62,72,212,70,0,2024-04-21
448,Graeme,81,87,58,226,75,0,2024-04-20
449,Gus,68,50,92,210,70,0,2024-04-19
450,Viviyan,99,95,96,290,96,0,2024-04-22
451,Gabby,50,66,50,166,55,0,2024-04-22
452,Sigfried,96,96,93,285,95,0,2024-04-16
453,Cele,71,56,87,214,71,0,2024-04-23
454,Verile,92,91,93,276,92,0,2024-04-12
455,Rebecca,99,95,79,273,91,0,2024-04-21
456,Caroljean,75,85,57,217,72,0,2024-04-19
457,Horton,97,68,97,262,87,0,2024-04-22
458,Sabrina,56,55,76,187,62,0,2024-04-14
459,Tobi,54,87,67,208,69,0,2024-04-20
460,Jarid,56,61,61,178,59,0,2024-04-22
461,Nike,93,77,82,252,84,0,2024-04-10
462,Ryann,65,77,75,217,72,0,2024-04-18
463,Cristionna,65,96,76,237,79,0,2024-04-10
464,Marina,94,58,65,217,72,0,2024-04-11
465,Reinold,90,54,54,198,66,0,2024-04-20
466,Bobbye,90,70,97,257,85,0,2024-04-19
467,Howey,79,62,54,195,65,0,2024-04-20
468,Olivette,72,98,74,244,81,0,2024-04-12
469,Dominica,93,70,100,263,87,0,2024-04-13
470,Edmon,78,61,81,220,73,0,2024-04-16
471,Lawry,91,71,89,251,83,0,2024-04-10
472,Tessie,54,54,69,177,59,0,2024-04-14
473,Enrichetta,90,57,91,238,79,0,2024-04-18
474,Delia,60,66,85,211,70,0,2024-04-16
475,Estele,92,96,90,278,92,0,2024-04-23
476,Graham,58,66,90,214,71,0,2024-04-22
477,Welby,82,83,92,257,85,0,2024-04-17
478,Fran,68,98,66,232,77,0,2024-04-18
479,Alexandra,81,75,54,210,70,0,2024-04-10
480,Buddy,70,51,83,204,68,0,2024-04-13
481,Bertine,61,67,91,219,73,0,2024-04-17
482,Shawn,68,74,67,209,69,0,2024-04-21
483,Ninnetta,80,50,100,230,76,0,2024-04-17
484,Gayle,73,67,68,208,69,0,2024-04-16
485,Mar,79,86,94,259,86,0,2024-04-14
486,Lorrie,83,61,94,238,79,0,2024-04-21
487,Alisha,53,57,72,182,60,0,2024-04-14
488,Rey,99,81,51,231,77,0,2024-04-11
489,Mill,75,98,76,249,83,0,2024-04-18
490,Eachelle,79,55,51,185,61,0,2024-04-21
491,Georgiana,54,66,60,180,60,0,2024-04-11
492,Maighdiln,69,51,90,210,70,0,2024-04-21
493,Hamid,76,73,53,202,67,0,2024-04-12
494,Norby,99,54,83,236,78,0,2024-04-21
495,Vivien,62,69,77,208,69,0,2024-04-16
496,Benoite,55,70,82,207,69,0,2024-04-21
497,Archambault,67,76,90,233,77,0,2024-04-17
498,Vincenz,95,64,67,226,75,0,2024-04-10
499,Aguistin,96,83,81,260,86,0,2024-04-20
500,Sherman,90,100,81,271,90,0,2024-04-14
501,Rossy,61,64,96,221,73,0,2024-04-18
502,Stillmann,82,84,60,226,75,0,2024-04-16
503,Gabriela,57,89,84,230,76,0,2024-04-10
504,Brigit,83,95,63,241,80,0,2024-04-15
505,Shani,77,64,93,234,78,0,2024-04-16
506,Marmaduke,51,93,78,222,74,0,2024-04-14
507,Nessa,53,59,79,191,63,0,2024-04-17
508,Corby,73,89,83,245,81,0,2024-04-12
509,Andy,78,54,71,203,67,0,2024-04-20
510,Micki,94,88,61,243,81,0,2024-04-20
511,Shaun,97,85,87,269,89,0,2024-04-13
512,Margi,89,76,85,250,83,0,2024-04-21
513,Keefer,57,78,98,233,77,0,2024-04-13
514,Felicia,97,63,93,253,84,0,2024-04-16
515,Halsy,87,54,91,232,77,0,2024-04-21
516,Hedwig,88,100,98,286,95,0,2024-04-17
517,Ediva,59,71,78,208,69,0,2024-04-20
518,Denis,52,98,65,215,71,0,2024-04-15
519,Christoffer,83,66,90,239,79,0,2024-04-16
520,Bay,58,60,68,186,62,0,2024-04-21
521,Benji,82,92,68,242,80,0,2024-04-18
522,Skylar,92,75,88,255,85,0,2024-04-10
523,Iolande,63,71,71,205,68,0,2024-04-17
524,Eve,91,68,88,247,82,0,2024-04-16
525,Rubia,67,52,88,207,69,0,2024-04-11
526,Giacopo,95,54,87,236,78,0,2024-04-11
527,Una,84,81,60,225,75,0,2024-04-18
528,Mikol,72,75,88,235,78,0,2024-04-18
529,Sigfrid,75,62,92,229,76,0,2024-04-13
530,Shoshanna,93,55,86,234,78,0,2024-04-16
531,Zechariah,54,93,51,198,66,0,2024-04-14
532,Berti,86,86,55,227,75,0,2024-04-20
533,Davina,60,85,73,218,72,0,2024-04-22
534,Roxana,97,93,75,265,88,0,2024-04-10
535,Karisa,89,83,60,232,77,0,2024-04-11
536,Lea,62,99,95,256,85,0,2024-04-23
537,Keelby,83,87,53,223,74,0,2024-04-10
538,Cortie,88,57,99,244,81,0,2024-04-15
539,Rinaldo,54,94,93,241,80,0,2024-04-16
540,Oliy,75,97,75,247,82,0,2024-04-13
541,Lowell,99,88,92,279,93,0,2024-04-20
542,Bevan,56,58,84,198,66,0,2024-04-22
543,Cullan,67,64,89,220,73,0,2024-04-13
544,Mack,96,100,71,267,89,0,2024-04-21
545,Bari,50,67,68,185,61,0,2024-04-10
546,Warren,65,73,89,227,75,0,2024-04-21
547,Lorraine,69,58,65,192,64,0,2024-04-10
548,Annabela,95,59,58,212,70,0,2024-04-15
549,Melinda,60,93,54,207,69,0,2024-04-20
550,Ingaborg,81,91,56,228,76,0,2024-04-14
551,Florenza,55,78,89,222,74,0,2024-04-11
552,Farlie,71,92,68,231,77,0,2024-04-19
553,Rina,93,84,94,271,90,0,2024-04-21
554,Sibella,57,88,59,204,68,0,2024-04-17
555,Laina,69,74,76,219,73,0,2024-04-23
556,Gearalt,68,52,72,192,64,0,2024-04-19
557,Darwin,88,72,71,231,77,0,2024-04-11
558,Kurt,85,66,53,204,68,0,2024-04-19
559,Urbano,75,97,95,267,89,0,2024-04-10
560,Shaw,75,61,80,216,72,0,2024-04-15
561,Igor,53,66,71,190,63,0,2024-04-20
562,Mabelle,98,79,54,231,77,0,2024-04-10
563,Arch,89,99,60,248,82,0,2024-04-12
564,Tabor,62,96,53,211,70,0,2024-04-11
565,Lynne,63,86,75,224,74,0,2024-04-11
566,Gerardo,80,82,54,216,72,0,2024-04-13
567,Elias,69,57,69,195,65,0,2024-04-23
568,Latrena,98,80,89,267,89,0,2024-04-16
569,Eric,50,64,86,200,66,0,2024-04-11
570,Elvira,91,82,66,239,79,0,2024-04-20
571,Faber,63,59,78,200,66,0,2024-04-10
572,Jane,83,72,94,249,83,0,2024-04-22
573,Fan,94,86,56,236,78,0,2024-04-21
574,Joya,80,60,84,224,74,0,2024-04-17
575,Barris,76,73,85,234,78,0,2024-04-14
576,Solly,65,85,58,208,69,0,2024-04-18
577,Daisi,78,77,68,223,74,0,2024-04-12
578,Melly,83,74,88,245,81,0,2024-04-23
579,Aurlie,100,75,63,238,79,0,2024-04-13
580,Pandora,95,56,86,237,79,0,2024-04-11
581,Sancho,78,97,71,246,82,0,2024-04-21
582,Annabela,59,97,95,251,83,0,2024-04-17
583,Abelard,60,72,74,206,68,0,2024-04-13
584,Alleyn,54,83,58,195,65,0,2024-04-13
585,Ezri,84,75,97,256,85,0,2024-04-20
586,Cob,74,99,69,242,80,0,2024-04-21
587,Colin,56,71,81,208,69,0,2024-04-22
588,Konstantin,83,63,56,202,67,0,2024-04-11
589,Reinald,78,73,90,241,80,0,2024-04-13
590,Fiann,55,72,76,203,67,0,2024-04-10
591,Lindsy,92,73,62,227,75,0,2024-04-11
592,Lefty,92,51,76,219,73,0,2024-04-12
593,Fifi,74,94,93,261,87,0,2024-04-17
594,Odelia,71,97,83,251,83,0,2024-04-22
595,Joelly,96,54,66,216,72,0,2024-04-20
596,Allis,67,79,91,237,79,0,2024-04-20
597,Lia,72,62,51,185,61,0,2024-04-15
598,Lane,83,97,85,265,88,0,2024-04-10
599,Carmon,79,59,88,226,75,0,2024-04-17
600,Mel,92,65,76,233,77,0,2024-04-13
601,Ingrid,77,99,77,253,84,0,2024-04-22
602,Nessi,58,91,53,202,67,0,2024-04-22
603,Viola,59,57,52,168,56,0,2024-04-16
604,Starr,88,62,84,234,78,0,2024-04-14
605,Any,58,74,100,232,77,0,2024-04-21
606,Heidie,70,68,88,226,75,0,2024-04-18
607,Verene,80,94,75,249,83,0,2024-04-17
608,Nona,61,82,83,226,75,0,2024-04-23
609,Klarika,73,62,82,217,72,0,2024-04-13
610,Randene,65,65,76,206,68,0,2024-04-15
611,Elia,83,66,66,215,71,0,2024-04-17
612,Esme,93,98,87,278,92,0,2024-04-11
613,Yard,54,61,54,169,56,0,2024-04-11
614,Orelia,67,90,80,237,79,0,2024-04-17
615,Gretel,54,87,91,232,77,0,2024-04-23
616,Lorne,93,66,84,243,81,0,2024-04-17
617,Merle,94,88,60,242,80,0,2024-04-15
618,Malachi,55,63,62,180,60,0,2024-04-19
619,Hamish,99,56,65,220,73,0,2024-04-21
620,Josie,67,64,57,188,62,0,2024-04-10
621,Sabine,69,52,62,183,61,0,2024-04-12
622,Gaultiero,96,74,74,244,81,0,2024-04-22
623,Carlo,96,68,55,219,73,0,2024-04-11
624,Anton,50,54,64,168,56,0,2024-04-16
625,Melosa,80,97,72,249,83,0,2024-04-11
626,Jillayne,83,85,52,220,73,0,2024-04-12
627,Dominick,65,90,88,243,81,0,2024-04-13
628,Tilly,66,66,60,192,64,0,2024-04-20
629,Alyce,74,99,68,241,80,0,2024-04-23
630,Ashton,79,81,57,217,72,0,2024-04-15
631,Myrwyn,100,86,86,272,90,0,2024-04-16
632,Jedd,64,88,98,250,83,0,2024-04-18
633,Casi,82,99,92,273,91,0,2024-04-23
634,Vicky,74,99,100,273,91,0,2024-04-19
635,Drucill,82,97,86,265,88,0,2024-04-19
636,Harcourt,77,70,80,227,75,0,2024-04-17
637,Betsey,73,60,79,212,70,0,2024-04-17
638,Kevina,89,81,91,261,87,0,2024-04-17
639,Catarina,55,50,51,156,52,0,2024-04-17
640,Ottilie,76,58,53,187,62,0,2024-04-14
641,Dianne,58,84,53,195,65,0,2024-04-14
642,Michael,56,77,74,207,69,0,2024-04-13
643,Brew,82,59,55,196,65,0,2024-04-14
644,Erhard,76,91,70,237,79,0,2024-04-12
645,Lyell,57,91,99,247,82,0,2024-04-19
646,Gabriela,69,63,50,182,60,0,2024-04-23
647,Marlon,51,75,88,214,71,0,2024-04-14
648,Franklin,81,66,89,236,78,0,2024-04-10
649,Eydie,97,79,75,251,83,0,2024-04-14
650,Micheline,87,70,51,208,69,0,2024-04-16
651,Abdel,71,98,93,262,87,0,2024-04-21
652,Addia,98,98,56,252,84,0,2024-04-10
653,Lianne,73,78,60,211,70,0,2024-04-10
654,Mellisent,53,73,70,196,65,0,2024-04-21
655,Felicdad,90,52,63,205,68,0,2024-04-13
656,Brew,92,57,70,219,73,0,2024-04-17
657,Karoly,57,94,50,201,67,0,2024-04-18
658,Bria,87,87,75,249,83,0,2024-04-15
659,Tabatha,59,92,59,210,70,0,2024-04-10
660,Myrta,98,54,92,244,81,0,2024-04-20
661,Aurelia,96,98,69,263,87,0,2024-04-22
662,Maryanne,93,68,73,234,78,0,2024-04-11
663,Lesley,51,76,80,207,69,0,2024-04-14
664,Colby,99,55,92,246,82,0,2024-04-12
665,Timmy,66,74,79,219,73,0,2024-04-19
666,Nydia,52,84,99,235,78,0,2024-04-14
667,Jedidiah,83,68,52,203,67,0,2024-04-19
668,Dyan,87,97,84,268,89,0,2024-04-15
669,Rhodia,94,91,81,266,88,0,2024-04-21
670,Nonie,91,92,52,235,78,0,2024-04-15
671,Chester,92,90,50,232,77,0,2024-04-20
672,Catherina,81,56,58,195,65,0,2024-04-11
673,Ianthe,58,79,79,216,72,0,2024-04-14
674,Winni,73,76,51,200,66,0,2024-04-22
675,Salli,96,75,71,242,80,0,2024-04-10
676,Jorge,57,66,75,198,66,0,2024-04-12
677,Hermine,83,71,98,252,84,0,2024-04-10
678,Ronny,68,75,88,231,77,0,2024-04-13
679,Cristiano,61,73,80,214,71,0,2024-04-18
680,Keeley,85,62,63,210,70,0,2024-04-11
681,Adina,91,94,82,267,89,0,2024-04-15
682,Leone,56,100,52,208,69,0,2024-04-20
683,Laure,74,95,90,259,86,0,2024-04-19
684,Lotta,74,94,62,230,76,0,2024-04-11
685,Iggy,58,95,57,210,70,0,2024-04-10
686,Uriah,52,53,89,194,64,0,2024-04-17
687,Aura,79,98,64,241,80,0,2024-04-14
688,Bail,53,84,88,225,75,0,2024-04-13
689,Shauna,61,67,97,225,75,0,2024-04-19
690,Rhys,75,77,78,230,76,0,2024-04-12
691,Rabi,59,100,50,209,69,0,2024-04-14
692,Adelaide,56,88,96,240,80,0,2024-04-12
693,Neron,54,73,50,177,59,0,2024-04-11
694,Ramsay,77,95,63,235,78,0,2024-04-22
695,Royce,78,100,81,259,86,0,2024-04-15
696,Dean,79,78,63,220,73,0,2024-04-11
697,Derk,52,81,90,223,74,0,2024-04-10
698,Wilmar,75,73,66,214,71,0,2024-04-23
699,Robby,73,78,53,204,68,0,2024-04-21
700,Carine,88,90,72,250,83,0,2024-04-14
701,Susannah,58,81,52,191,63,0,2024-04-13
702,Hervey,93,74,63,230,76,0,2024-04-19
703,Drucy,59,70,69,198,66,0,2024-04-17
704,Jemmy,83,74,90,247,82,0,2024-04-18
705,Colin,94,97,77,268,89,0,2024-04-10
706,Marleen,55,87,69,211,70,0,2024-04-12
707,Sonny,89,85,100,274,91,0,2024-04-17
708,Barty,91,93,66,250,83,0,2024-04-10
709,Aurilia,66,68,72,206,68,0,2024-04-23
710,Axel,90,58,83,231,77,0,2024-04-13
711,Lexie,83,80,98,261,87,0,2024-04-18
712,Selene,100,70,86,256,85,0,2024-04-14
713,Bette-ann,99,91,69,259,86,0,2024-04-12
714,Kory,96,75,68,239,79,0,2024-04-19
715,Rivy,63,76,56,195,65,0,2024-04-13
716,Dela,69,58,69,196,65,0,2024-04-11
717,Carissa,52,81,63,196,65,0,2024-04-15
718,Elbertine,73,77,64,214,71,0,2024-04-15
719,Tomasina,62,59,93,214,71,0,2024-04-17
720,Junina,97,59,96,252,84,0,2024-04-15
721,Catherin,67,61,57,185,61,0,2024-04-18
722,Jeth,77,57,80,214,71,0,2024-04-12
723,Neila,70,99,78,247,82,0,2024-04-23
724,Hermina,62,74,70,206,68,0,2024-04-18
725,Jack,67,90,57,214,71,0,2024-04-19
726,Fairleigh,89,96,55,240,80,0,2024-04-11
727,Christabel,68,57,60,185,61,0,2024-04-22
728,Teddy,74,87,94,255,85,0,2024-04-21
729,Verna,60,75,51,186,62,0,2024-04-12
730,Deonne,59,89,52,200,66,0,2024-04-12
731,Wyatan,62,61,87,210,70,0,2024-04-18
732,Gerardo,93,56,67,216,72,0,2024-04-12
733,Fax,62,96,71,229,76,0,2024-04-22
734,Michaelina,69,94,59,222,74,0,2024-04-19
735,Piper,59,79,95,233,77,0,2024-04-11
736,Philomena,54,73,52,179,59,0,2024-04-21
737,Sarena,83,80,78,241,80,0,2024-04-23
738,Emmalee,72,68,83,223,74,0,2024-04-16
739,Claus,93,54,90,237,79,0,2024-04-19
740,Abbi,64,72,51,187,62,0,2024-04-18
741,Giavani,79,76,73,228,76,0,2024-04-21
742,Staffard,53,77,59,189,63,0,2024-04-10
743,Mab,77,78,74,229,76,0,2024-04-19
744,Ansley,57,85,70,212,70,0,2024-04-10
745,Geraldine,79,54,51,184,61,0,2024-04-13
746,Beverly,91,76,94,261,87,0,2024-04-15
747,Irvine,70,84,87,241,80,0,2024-04-22
748,Edith,83,69,96,248,82,0,2024-04-14
749,Wain,52,54,97,203,67,0,2024-04-19
750,Enrichetta,87,82,98,267,89,0,2024-04-22
751,Rozina,70,55,77,202,67,0,2024-04-10
752,Elladine,60,88,60,208,69,0,2024-04-22
753,Filbert,58,92,58,208,69,0,2024-04-15
754,Tate,89,56,92,237,79,0,2024-04-12
755,Norri,76,82,71,229,76,0,2024-04-14
756,Zahara,59,72,66,197,65,0,2024-04-20
757,Matthiew,80,73,77,230,76,0,2024-04-17
758,Leora,95,60,72,227,75,0,2024-04-11
759,Hermy,58,83,94,235,78,0,2024-04-15
760,Conn,78,87,83,248,82,0,2024-04-19
761,Flinn,61,67,50,178,59,0,2024-04-17
762,Tully,91,97,92,280,93,0,2024-04-13
763,Harlie,51,90,97,238,79,0,2024-04-22
764,Ellis,81,69,83,233,77,0,2024-04-13
765,Sunny,98,87,95,280,93,0,2024-04-21
766,Ursala,86,85,81,252,84,0,2024-04-14
767,Evangelia,82,72,50,204,68,0,2024-04-13
768,Artus,66,50,69,185,61,0,2024-04-23
769,Stafani,84,94,58,236,78,0,2024-04-15
770,Adelaida,72,67,59,198,66,0,2024-04-19
771,Ernestus,85,65,63,213,71,0,2024-04-12
772,Yoko,55,82,97,234,78,0,2024-04-13
773,Caitrin,60,78,55,193,64,0,2024-04-11
774,Ceciley,91,56,96,243,81,0,2024-04-22
775,Micaela,51,88,52,191,63,0,2024-04-12
776,Seth,85,70,100,255,85,0,2024-04-14
777,Carita,92,60,84,236,78,0,2024-04-20
778,Artair,75,95,99,269,89,0,2024-04-19
779,Jeremiah,94,57,97,248,82,0,2024-04-22
780,Janos,74,91,91,256,85,0,2024-04-23
781,Cassy,78,82,59,219,73,0,2024-04-11
782,Lon,79,83,100,262,87,0,2024-04-12
783,Anstice,95,56,98,249,83,0,2024-04-22
784,Micky,51,87,97,235,78,0,2024-04-14
785,Joly,87,99,75,261,87,0,2024-04-14
786,Cherish,98,61,98,257,85,0,2024-04-21
787,Zacherie,72,57,71,200,66,0,2024-04-23
788,Malva,80,72,84,236,78,0,2024-04-18
789,Trever,57,71,75,203,67,0,2024-04-15
790,Cassandra,90,80,51,221,73,0,2024-04-23
791,Vail,89,94,93,276,92,0,2024-04-18
792,Mathian,72,56,69,197,65,0,2024-04-12
793,Adaline,85,84,53,222,74,0,2024-04-11
794,Laraine,54,85,66,205,68,0,2024-04-21
795,Patrice,63,82,76,221,73,0,2024-04-12
796,Marcela,99,55,89,243,81,0,2024-04-11
797,Em,78,85,100,263,87,0,2024-04-23
798,Colene,50,57,54,161,53,0,2024-04-18
799,Whitney,99,99,73,271,90,0,2024-04-19
800,Rhodia,55,94,76,225,75,0,2024-04-16
801,Emelia,64,89,86,239,79,0,2024-04-21
802,Iggie,76,77,65,218,72,0,2024-04-10
803,Benji,93,92,56,241,80,0,2024-04-11
804,Irita,54,79,93,226,75,0,2024-04-10
805,Odie,52,93,79,224,74,0,2024-04-16
806,Romeo,54,81,67,202,67,0,2024-04-22
807,Isidro,78,70,55,203,67,0,2024-04-13
808,Cosetta,72,63,70,205,68,0,2024-04-12
809,Esmaria,80,74,70,224,74,0,2024-04-21
810,Maude,69,66,51,186,62,0,2024-04-18
811,Silvain,59,67,70,196,65,0,2024-04-16
812,Kerry,73,70,78,221,73,0,2024-04-17
813,Etan,51,74,87,212,70,0,2024-04-17
814,Arny,63,99,84,246,82,0,2024-04-16
815,Leta,68,95,67,230,76,0,2024-04-18
816,Bree,76,57,91,224,74,0,2024-04-16
817,Florella,87,66,86,239,79,0,2024-04-17
818,Hillary,74,90,51,215,71,0,2024-04-11
819,Caroljean,62,72,51,185,61,0,2024-04-10
820,Gilberte,75,99,52,226,75,0,2024-04-18
821,Edouard,51,97,58,206,68,0,2024-04-21
822,Tobey,58,71,55,184,61,0,2024-04-18
823,Jonas,96,63,50,209,69,0,2024-04-22
824,Jocko,82,92,83,257,85,0,2024-04-12
825,Tiffy,96,67,82,245,81,0,2024-04-19
826,Edwin,98,78,69,245,81,0,2024-04-13
827,John,62,77,91,230,76,0,2024-04-19
828,Enrika,65,71,88,224,74,0,2024-04-18
829,Kerk,89,84,96,269,89,0,2024-04-12
830,Rancell,97,94,94,285,95,0,2024-04-11
831,Guss,95,75,91,261,87,0,2024-04-10
832,Akim,55,96,70,221,73,0,2024-04-13
833,Hildegarde,67,88,61,216,72,0,2024-04-19
834,Tera,55,92,57,204,68,0,2024-04-13
835,Bobbye,93,64,93,250,83,0,2024-04-15
836,Ilyse,100,72,58,230,76,0,2024-04-17
837,Mylo,52,53,77,182,60,0,2024-04-10
838,Benn,96,89,99,284,94,0,2024-04-11
839,Westleigh,58,81,68,207,69,0,2024-04-23
840,Rasla,67,69,70,206,68,0,2024-04-17
841,Timothy,91,96,86,273,91,0,2024-04-17
842,Giovanni,88,67,93,248,82,0,2024-04-11
843,Noelyn,70,87,78,235,78,0,2024-04-23
844,Malia,54,63,50,167,55,0,2024-04-14
845,Minetta,55,91,100,246,82,0,2024-04-14
846,Dominique,80,91,66,237,79,0,2024-04-23
847,Ralina,80,98,92,270,90,0,2024-04-15
848,Reinaldo,60,55,87,202,67,0,2024-04-10
849,Bealle,68,77,81,226,75,0,2024-04-22
850,Emlynne,86,93,59,238,79,0,2024-04-10
851,Cathe,53,97,52,202,67,0,2024-04-17
852,Kimberlee,79,53,71,203,67,0,2024-04-20
853,Shell,80,80,66,226,75,0,2024-04-17
854,Thorny,94,64,58,216,72,0,2024-04-12
855,Fonz,82,81,80,243,81,0,2024-04-13
856,Linn,62,59,66,187,62,0,2024-04-23
857,Babs,82,85,86,253,84,0,2024-04-19
858,Devlen,60,66,64,190,63,0,2024-04-19
859,Inesita,93,91,80,264,88,0,2024-04-12
860,Evie,55,90,65,210,70,0,2024-04-15
861,Susanne,92,93,65,250,83,0,2024-04-17
862,Vita,71,98,88,257,85,0,2024-04-13
863,Quinton,62,67,89,218,72,0,2024-04-20
864,Lily,65,78,52,195,65,0,2024-04-17
865,Lynna,76,60,75,211,70,0,2024-04-20
866,Dexter,58,92,69,219,73,0,2024-04-12
867,Devin,57,89,74,220,73,0,2024-04-10
868,Hulda,94,63,94,251,83,0,2024-04-19
869,Modestine,89,54,91,234,78,0,2024-04-19
870,Sullivan,61,72,50,183,61,0,2024-04-20
871,Tiler,67,57,97,221,73,0,2024-04-20
872,Mara,83,53,58,194,64,0,2024-04-16
873,Elsey,99,94,86,279,93,0,2024-04-15
874,Helli,100,97,50,247,82,0,2024-04-11
875,Sharity,57,72,90,219,73,0,2024-04-12
876,Anita,84,78,89,251,83,0,2024-04-11
877,Dunstan,79,63,73,215,71,0,2024-04-21
878,Adoree,60,88,70,218,72,0,2024-04-11
879,Melvin,57,76,50,183,61,0,2024-04-16
880,Dani,65,69,64,198,66,0,2024-04-10
881,Pippa,54,54,76,184,61,0,2024-04-23
882,Bellanca,65,61,54,180,60,0,2024-04-17
883,Humberto,78,100,81,259,86,0,2024-04-12
884,Olga,52,73,62,187,62,0,2024-04-17
885,Jeannette,55,87,81,223,74,0,2024-04-23
886,Aylmar,75,87,52,214,71,0,2024-04-17
887,Konstance,72,71,74,217,72,0,2024-04-14
888,Archer,88,91,81,260,86,0,2024-04-10
889,Carroll,61,99,67,227,75,0,2024-04-15
890,Keri,63,58,50,171,57,0,2024-04-13
891,Cathy,72,50,92,214,71,0,2024-04-17
892,Meredith,73,71,94,238,79,0,2024-04-14
893,Tildy,97,70,79,246,82,0,2024-04-19
894,Juliet,68,67,59,194,64,0,2024-04-20
895,Paulette,76,81,85,242,80,0,2024-04-19
896,Kipp,58,72,63,193,64,0,2024-04-16
897,Leann,69,56,72,197,65,0,2024-04-13
898,Arabella,64,69,88,221,73,0,2024-04-20
899,Marvin,61,73,100,234,78,0,2024-04-17
900,Madlen,96,55,82,233,77,0,2024-04-16
901,Wolfie,80,62,91,233,77,0,2024-04-21
902,Dunn,68,83,54,205,68,0,2024-04-19
903,Angela,96,70,68,234,78,0,2024-04-17
904,Sheelah,64,81,79,224,74,0,2024-04-20
905,Marena,93,100,74,267,89,0,2024-04-21
906,Shena,99,81,71,251,83,0,2024-04-14
907,Liliane,73,64,98,235,78,0,2024-04-18
908,Beilul,53,59,94,206,68,0,2024-04-13
909,Austen,87,93,65,245,81,0,2024-04-12
910,Aili,63,76,95,234,78,0,2024-04-16
911,Alley,100,62,80,242,80,0,2024-04-23
912,Luis,70,63,52,185,61,0,2024-04-18
913,Paquito,93,59,61,213,71,0,2024-04-14
914,Udall,83,96,65,244,81,0,2024-04-19
915,Jacquetta,84,92,97,273,91,0,2024-04-15
916,Troy,54,58,71,183,61,0,2024-04-21
917,Berkeley,76,82,80,238,79,0,2024-04-21
918,Isidore,90,87,62,239,79,0,2024-04-22
919,Courtnay,73,90,94,257,85,0,2024-04-21
920,Sabrina,65,60,86,211,70,0,2024-04-11
921,Blinni,76,86,76,238,79,0,2024-04-23
922,Brittan,67,55,87,209,69,0,2024-04-10
923,Silvain,98,74,80,252,84,0,2024-04-19
924,Rafaela,90,51,92,233,77,0,2024-04-14
925,Chloris,53,71,71,195,65,0,2024-04-10
926,Dionysus,67,99,99,265,88,0,2024-04-13
927,Rolf,54,54,69,177,59,0,2024-04-22
928,Fabien,95,69,67,231,77,0,2024-04-20
929,Marlie,100,54,76,230,76,0,2024-04-12
930,Dukie,86,76,97,259,86,0,2024-04-23
931,Bertine,76,56,55,187,62,0,2024-04-19
932,Haskell,55,79,78,212,70,0,2024-04-15
933,Ignatius,80,93,96,269,89,0,2024-04-18
934,Susan,80,94,90,264,88,0,2024-04-20
935,Cris,82,63,60,205,68,0,2024-04-16
936,Carmelita,54,72,92,218,72,0,2024-04-12
937,Tansy,79,69,69,217,72,0,2024-04-14
938,Maryjo,56,93,63,212,70,0,2024-04-21
939,Betti,87,75,55,217,72,0,2024-04-10
940,Berri,66,51,67,184,61,0,2024-04-10
941,Lusa,69,63,78,210,70,0,2024-04-11
942,Wynn,93,79,73,245,81,0,2024-04-16
943,Joete,66,87,71,224,74,0,2024-04-23
944,Ailene,79,90,58,227,75,0,2024-04-16
945,Seka,58,51,96,205,68,0,2024-04-23
946,Margaretha,90,76,53,219,73,0,2024-04-19
947,Rouvin,71,66,99,236,78,0,2024-04-13
948,Hallie,72,89,71,232,77,0,2024-04-15
949,Hartwell,99,52,85,236,78,0,2024-04-14
950,Andria,98,86,78,262,87,0,2024-04-22
951,Benetta,77,67,82,226,75,0,2024-04-17
952,Percy,59,90,78,227,75,0,2024-04-23
953,Conant,97,76,53,226,75,0,2024-04-16
954,Morton,68,93,78,239,79,0,2024-04-12
955,Sheba,61,73,86,220,73,0,2024-04-17
956,Cece,67,61,67,195,65,0,2024-04-17
957,Albertina,95,62,64,221,73,0,2024-04-12
958,Fredrika,55,52,96,203,67,0,2024-04-17
959,Gayleen,69,99,81,249,83,0,2024-04-16
960,Lianna,57,91,81,229,76,0,2024-04-11
961,Vanessa,98,58,80,236,78,0,2024-04-20
962,Nellie,52,84,77,213,71,0,2024-04-20
963,Odelinda,75,96,79,250,83,0,2024-04-19
964,Eula,90,84,58,232,77,0,2024-04-18
965,Eliza,83,71,54,208,69,0,2024-04-15
966,Charlie,62,89,54,205,68,0,2024-04-10
967,Roxana,70,99,54,223,74,0,2024-04-19
968,Shelby,57,99,85,241,80,0,2024-04-10
969,Dorie,73,70,95,238,79,0,2024-04-18
970,Jaquith,91,80,86,257,85,0,2024-04-19
971,Clarie,92,57,87,236,78,0,2024-04-13
972,Jerrylee,50,51,77,178,59,0,2024-04-14
973,Daron,81,64,63,208,69,0,2024-04-21
974,Field,94,99,94,287,95,0,2024-04-22
975,Beret,94,99,82,275,91,0,2024-04-23
976,Berti,72,65,99,236,78,0,2024-04-11
977,Avictor,77,86,60,223,74,0,2024-04-17
978,Emelina,60,86,80,226,75,0,2024-04-15
979,Joshuah,86,100,96,282,94,0,2024-04-23
980,Myron,89,74,57,220,73,0,2024-04-19
981,Josepha,61,65,50,176,58,0,2024-04-15
982,Millicent,54,62,90,206,68,0,2024-04-20
983,Patrice,81,65,81,227,75,0,2024-04-10
984,Gretna,58,69,70,197,65,0,2024-04-10
985,Nat,73,60,50,183,61,0,2024-04-19
986,Pammi,60,87,75,222,74,0,2024-04-18
987,Joellyn,55,94,69,218,72,0,2024-04-23
988,Emlyn,86,75,75,236,78,0,2024-04-12
989,Marlie,94,80,91,265,88,0,2024-04-11
990,Faythe,82,52,63,197,65,0,2024-04-19
991,Chadwick,81,64,97,242,80,0,2024-04-22
992,Coretta,74,58,63,195,65,0,2024-04-11
993,Reine,67,89,81,237,79,0,2024-04-23
994,Elissa,64,87,99,250,83,0,2024-04-19
995,Phip,77,74,89,240,80,0,2024-04-19
996,Nanci,92,62,81,235,78,0,2024-04-11
997,Luther,56,61,56,173,57,0,2024-04-18
998,Dode,81,53,63,197,65,0,2024-04-21
999,Myrah,57,74,51,182,60,0,2024-04-20
1000,Susanne,78,73,89,240,80,0,2024-04-17
